M0 1 2 1 0 9
F0 1 2 0 1 2
M1 0 2 0 1 2
F1 2 2 1 0 2
M2 1 2 1 1 2
F2 1 2 0 0 2